("               ",
"               ",
"               ",
"               ",
"   111         ",
"  1  1 1111    ",
"  1  1 1  1 11 ",
"111111111111111",
"111111111111111",
),