("               ",
"               ",
"               ",
"               ",
"  1 1 1 1 1 1  ",
"  1 1 1 1 1 1  ",
" 4141414141414 ",
"111111111111111",
"111111111111111",
),("1111111111     ",
"1       11     ",
"1       11     ",
"     1  11     ",
"  1111      1  ",
"  1         1  ",
" 41         1  ",
"111  11    4111",
"111111111111111",
),