("               ",
"               ",
"      111      ",
"       1       ",
"   111111111   ",
"  1   111   1  ",
"  1    1    1  ",
"111111111111111",
"111111111111111",
),("               ",
"   722222226   ",
"  72222222226  ",
"  72  222  26  ",
"  72722222626  ",
"  2   222   2  ",
"               ",
"000000000000000",
"111111111111111",
),("               ",
"   222222226   ",
"   22     22   ",
"   2       2   ",
"227272222262622",
"               ",
"               ",
"11  11 11  11  ",
"112211211221122",
),("1              ",
"1              ",
"1  111  1111   ",
"1  1111111111  ",
"111111111111   ",
"              1",
"             11",
"111111111111111",
"111111111111111",
),("               ",
"               ",
"     1    1    ",
"     111111    ",
"    11111111   ",
"1             1",
"11           11",
"111111111111111",
"111111111111111",
),("               ",
"               ",
"               ",
"     111       ",
"    11 1114    ",
"  11 1 1  1    ",
"  1  1 1  1 11 ",
"111111111111111",
"111111111111111",
),("               ",
"               ",
"               ",
"            111",
"   1  4  4  1 1",
"  11  0  0  111",
"1111  1  1  111",
"111133133133111",
"               ",
),